111111111111111111111111111111111111111111
1000X0000000000000000000000011100000000011
10000000000000000000000000001C100000000011
10000000000000000000000000001E100000000011
1000000000000C0000000000000010100000000011
100000000000000000000000000000X00000000011
100000000000000000000000000000000000000011
10000X000000000000000000000000000000000011
1000000000000P0000000000000000000000000011
100000000000000000000000000000C00000000011
100000000000000000000000000000000000000011
100000000000000000000000000000000000000011
111111111111111111111111111111111111111111
